Ibrahim	Male
Muhammadu	Male
Habiba	Female
Zubairu	Male
Dalatu	Male
Shu'aibu	Male
Mustapha	Male
Bello	Male
Umar	Male
Saminu	Male
Sani	Male
Aliyu	Male
Adamu	Male
Abdullahi	Male
Garba	Male
Magajiya	Female
Saude	Female
Hauwa	Female
Sa'a	Female
Delu	Female
Binta	Female
Rabi	Female
Gambo	Female
Kulu	Female
Hadiza	Female
Saratu	Female
Suwaiba	Female
Kande	Female
Talle	Female
Jummai	Female
Lubabatu	Female
Sadiya	Female
Bilkisu	Female
Amina	Female
Yahanasu	Female
Maryam	Female
Habiba	Female
Karime	Female
Rukaiyya	Female
Rahane	Female
Ladi	Female
Amadu	Male
Nasiru	Male
Jamilu	Male
Jamila	Female
Isma'il	Male
Mandawari	Male
Kabiru	Male
Murtala	Male
Aisha	Female
Fiddausi	Female
Hassan	Male
Felix	Male
John	Male
Salisu	Male